easy_10x10
%%%%%%%%%%
%S%......%
%.%%%%%%.%
%......%.%
%...%%%.%
%.%.....%
%.%.%%%%%
%.%.%...%
%..G....%
%%%%%%%%%%

medium_10x10
%%%%%%%%%%
%S%......%
%.%%%%%%.%
%.%...%%.%
%.%.%..%.%
%.%.%%.%.%
%......%.%
%.%%%%.%.%
%......G%
%%%%%%%%%%

hard_10x10
%%%%%%%%%%
%S%......%
%.%%%%%%.%
%........%
%.%%.%%.%
%.%...%.%
%.%.%.%.%
%.%...%.%
%.%%.%%.%
%......G%
%%%%%%%%%%
