%%%%%%%%%%%%%%%%%%%%
%S.................%
%.%%%%%.%%%%%.%%%%%
%.....%.....%.....%
%.%%%.%%%.%%%.%%%.%
%...%...%...%...%.%
%.%.%.%.%.%.%.%.%.%
%...%...%...%...%.%
%.%%%.%%%.%%%.%%%.%
%.....%.....%.....%
%.%%%%%.%%%%%.%%%%%
%.......%.........%
%.%%%.%%%.%%%.%%%.%
%...%...%...%...%.%
%.%.%.%.%.%.%.%.%.%
%...%...%...%...%.%
%.%%%.%%%.%%%.%%%.%
%.....%.....%.....%
%.%%%%%%%%%.%%%%%.%
%............G....%
%%%%%%%%%%%%%%%%%%%%
